kuusi	mänty	VIERUSKÄSITE
kuusi	viisi	VIERUSKÄSITE
peli	leikki	SYNONYYMI
aamu	ilta	ANTONYYMI
vasikka	lehmä	HYPONYYMI	KUVAINNOLLINEN
juusto	feta	HYPERONYYMI
uhka	vaara	SYNONYYMI
vuori	kangas	VIERUSKÄSITE	KAKSOISMERKITYS
ruisleipä	patonki	VIERUSKÄSITE
este	haaste	SYNONYYMI
valo	pimeä	ANTONYYMI
aikuinen	lapsi	ANTONYYMI
mäki	vuori	SYNONYYMI
pelko	kauhu	SYNONYYMI
uni	painajainen	SYNONYYMI
meri	järvi	VIERUSKÄSITE
maa	valtio	SYNONYYMI
multa	maa	SYNONYYMI
honka	mänty	SYNONYYMI
laiva	vene	SYNONYYMI
kuume	flunssa	VIERUSKÄSITE
pyrstötähti	komeetta	SYNONYYMI
observatorio	tähtitorni	SYNONYYMI
äiti	isä	ANTONYYMI
Suomi	suomalainen	VIERUSKÄSITE
Ruotsi	Suomi	VIERUSKÄSITE
elämä	kuolema	ANTONYYMI
syntymä	kuolema	ANTONYYMI
seula	siivilä	SYNONYYMI
hevonen	muuli	VIERUSKÄSITE
joki	puro	SYNONYYMI
allergia	erikoisruokavalio	VIERUSKÄSITE
ravintola	ruokala	VIERUSKÄSITE
eduskunta	parlamentti	SYNONYYMI
hälytysajoneuvo	ambulanssi	HYPERONYYMI
äiti	nainen	HYPONYYMI
lapsi	äiti	VIERUSKÄSITE
maa	Suomi	HYPERONYYMI
ministeri	presidentti	VIERUSKÄSITE
haava	naarmu	SYNONYYMI







samanlaisuus	ero 	ANTONYYMI
palkinto	kiitos	VIERUSKÄSITE
peli	soitin	SYNONYYMI
suru	ero 	
seppä	rauta	
aika	vuosi	
housut	hattu	VIERUSKÄSITE
hissi	portaat	VIERUSKÄSITE
joki	metsä	VIERUSKÄSITE
lapio	vasara	VIERUSKÄSITE
paperi	kangas	VIERUSKÄSITE
multa	hauta
omena	tomaatti	VIERUSKÄSITE
kaupunki	valtio	VIERUSKÄSITE
lämmitys	halko	VIERUSKÄSITE
sairaus	huimaus	HYPERONYYMI
nainen	lääkäri	VIERUSKÄSITE
leipä	vehnä
pettymys	epätoivo	VIERUSKÄSITE
vaha	pinta	
vaha	kiille	
jälleenrakentaminen	rauha	VIERUSKÄSITE
aloitusvalikko	peli	
reki	vaunut	VIERUSKÄSITE
autotie	polku	VIERUSKÄSITE
susi	eläin	HYPONYYMI
susi	nisäkäs	HYPONYYMI
susi	kotka	VIERUSKÄSITE
matelija	nisäkäs	VIERUSKÄSITE
näppäimistö	hiiri	VIERUSKÄSITE 	KAKSOISMERKITYS
sormi	käsi	MERONYYMI
ratti	auto 	MERONYYMI
sivu	kirja 	MERONYYMI
metsä	koivu 	HOLONYYMI
ammattikorkeakoulu	ala-aste	VIERUSKÄSITE
veitsi	juomalasi	VIERUSKÄSITE
olut	Alko 	
tulostin	toimisto	MERONYYMI
värikynä	tulostin 	VIERUSKÄSITE
sakset	paperi	VIERUSKÄSITE






viini	harakka
kori	henki
este	vasikka
näppäimistö	kiitos
kirjanmerkki	vehnä
pöytä	hiiri
leipä	vuori
kirjain	palkinto
suru	ruuvi
vaha	henkilö
simpukka	kavio
liima	sukka
puolalainen	vihannes
oppitunti	hai
seesami	vahinko
sirkus	käsi
ennakkonäytös	kahva
vilkku	sairasloma
lumi	ankerias
kylmyys	porkkana
tieto	elämä
savi	epävarmuus
reki	sisilisko
kemia	karonkka
oikku	kaisla
innostus	meri
erämaa	apu
enkeli	puolalainen
kevät	kirjain
porkkana	lasi
hai	seesami
rauha	entisöinti
elämys	vihollinen
leipä	professori
jalokivi	kylmyys
ihminen	virtaus
tilannetaju	jakoavain
nuudeli	lauta
juoma	epävarmuus
este	reki


sarjakuva	lehti
vesi	pullo
lamppu	henki
kilpailu	etu
meri	harakka	



lautanen	lauta
varasto	vara
esitys	esitelmä
näytös	näytelmä
kirjavuus	kirja
puukko	puu
puutuminen	puu
silmu	silmä
taipumus	taipuminen
seikka	seikkailu









